MMMMMMMMMMMMMMMMMMMMMMMMMMMMMMMMMMMMMMMMMM
MMMMMMMMMMMMMMMMMMMMMMMMMMMMMMMMMMMMMMMMMM
MMMMMMMMMMMMMMMMMMMMMMMMMMMMMMMMMMMMMMMMMM
MMMPPPPPPPPPPMPPPPRRPRPRPPPPPPMPPPPPPPPMMM
MMMPRRRPRPRPPPPPRPPPPRPRPRRRPPPPPPPPPGPMMM
MMMPPPPPRPRPPMPPRPRRPPPPPRPPPPMPPPPPPPPMMM
MMMPRRMMMMMMMMMMMMMMMMMMMMMMMMMMMMMMMMMMMM
MMMPRPMMMMMMMMMMMMMMMMMMMMMMMMMMMMMMMMMMMM
MMMPRPPRPPPPPPMPPPPPRPRPPPPMPPPPPRPPRPPMMM
MMMPRPPRPRRRPPPPPRPPRPRRRPPPPPRPPRPPRRPMMM
MMMPPPPPPPPRPPMPPRPPPPPPRPPMPPRPPPPPPPPMMM
MMMMMMMMMMMMMMMMMMMMMMMMMMMMMMMMMMMMPRPMMM
MMMMMMMMMMMMMMMMMMMMMMMMMMMMMMMMMMMMPPPMMM
MMMMMMMMMMMMMMMMMMMMMMMMMMMMMMMMMMMMMPMMMM
MMMMMMMMMMMMMMMMMMMMMMMMMMMMMMMMMMMMPPPMMM
MMMMMMMMMMMMMMMMMMMMMMMMMMMMMMMMMMMMPPPMMM
MMMPPPPRPMPPRPPPPPRPPPPPRPPPPMPPPPRRPRPMMM
MMMPPPPRPPPRRPPRPPRPRRPPRPRRPPPPRPPRPRPMMM
MMMRRPPPPMPPPPPRPPPPPRPPPPPPPMPPRPPPPPPMMM
MMMPPPMMMMMMMMMMMMMMMMMMMMMMMMMMMMMMMMMMMM
MMMRRPMMMMMMMMMMMMMMMMMMMMMMMMMMMMMMMMMMMM
MMMPPPMMMMMMMMMMMMMMMMMMMMMMMMMMMMMMMMMMMM
MMMPRPMMMMMMMMMMMMMMMMMMMMMMMMMMMMMMMMMMMM
MMMPRPPPPMPPPPPRPPPPPPPRPPMPPPRPPRPPPPPMMM
MMMPRRPRPPPPRRPRRRPRRRPRRPPPRPRRPRPRPPPMMM
MMMPPPPRPMPPPPPPPRPRPPPPPPMPPPPPPPPRRRPMMM
MMMMMMMMMMMMMMMMMMMMMMMMMMMMMMMMMMMMPPPMMM
MMMMMMMMMMMMMMMMMMMMMMMMMMMMMMMMMMMMRRPMMM
MMMMMMMMMMMMMMMMMMMMMMMMMMMMMMMMMMMMPPPMMM
MMMMMMMMMMMMMMMMMMMMMMMMMMMMMMMMMMMMRRPMMM
MMMPPPPRPPPPRPPPPMPPPPPPPRRRPPPRPMPRPRPMMM
MMMRRRPRPRPPRPRRPPPPRPRRPRPPPPPRPPPRPRPMMM
MMMPPPPPPRPPPPPPPMPPRPPRPRPPRRPPPMPPPPPMMM
MMMPRRMMMMMMMMMMMMMMMMMMMMMMMMMMMMMMMMMMMM
MMMPPPMMMMMMMMMMMMMMMMMMMMMMMMMMMMMMMMMMMM
MMMPRRMMMMMMMMMMMMMMMMMMMMMMMMMMMMMMMMMMMM
MMMPPRPPPPPPRPPPRPPRPMPPPPPPRPPPPPPPPPPMMM
MMMPPRRRPRPPRPPRRRPRPPPRPRRPRPRPPRPPPSPMMM
MMMPPPPPPRPPPPPPPPPRPMPRPPPPPPPPPRPPPPPMMM
MMMMMMMMMMMMMMMMMMMMMMMMMMMMMMMMMMMMMMMMMM
MMMMMMMMMMMMMMMMMMMMMMMMMMMMMMMMMMMMMMMMMM
MMMMMMMMMMMMMMMMMMMMMMMMMMMMMMMMMMMMMMMMMM